19
15
LPLHPLLLLLPFLLH
PPFLHPFPLLPFFHF
LHLLLLPPFFHPHPL
PLHFHLFFFPPHLHP
LLPHHPLPHHHFPFH
FHHPPLPFFHLHFHH
FHPFLHLPFPFFLPH
FHPLHPHLLFFLPHL
PHFHFFPFPHPFLPP
LLHPLLPPHHPHPLH
HFHLPHFPFLHHPPH
LLHFLLPPFFLHHPL
FFLHPLHLHHLFPLF
LHFFHFHHHPPHPFF
PFFHLPFFPPFHFPP
LLHPPLFPFHPLLHF
FHPLLLLHFHPHLPP
FPFHPHPPHFFPFPL
PPFLLPPHLFLLHLH
lrover west 4 8 f
lrover south 0 5 f a
